5
10
S--D------
-D----D-D-
---D---J--
DD---D-D--
---------D

